





                 X
               T
               X
             B  T
   TT        X  X   C
 XAXX     F X      TX   DX
  X  XT   X   X    X X  X  X
X     X E              T  X
       XT  X      X    X
        X             X

         T
         X

		 
		 